BBBBBBBBBBBBBBBBBBBBBBBBBBBBBBBB
B___B________B____B________B___B
B_C_B___E____B_P__B____E___B_C_B
B___B________B____B________B___B
BBBBB______________________BBBBB
____E_____BB________BB_____E____
____________B______B____________
BBBBBBBB_______BB_______BBBBBBBB
B___E__B________________B__E___B
B__C___B_______EE_______B___C__B
B______B________________B______B
BBB__BBBBBBBB__BB__BBBBBBBB__BBB
B______________BB______________B
B_______E______BB______E_______B
B___BBBBBBBBBBBBBBBBBBBBBBBB___B
B___B__________EE__________B___B
B___B______________________B___B
B__E____BBB____BB____BBB____E__B
B_______B___E______E___B_______B
BBBBBBBBB______________BBBBBBBBB
B___B________B____B________B___B
B_C_B____E___B__D_B___E____B_C_B
B___B________B____B________B___B
BBBBBBBBBBBBBBBBBBBBBBBBBBBBBBBB