BBBBBBBBBBBBBBBBBBBBBBBBBBBBBBBB
B__B__E__B___E_____B__B__E___BBB
B________B_________B__B______BBB
B_E___BBBBBBBBBB_E_B_____BB____B
B___P_BB__BB__BB_________BB____B
B_E___BB__E________E__BBBBB__BBB
BBB___________E___BBBB_____BB__B
BBB_______BBBB__BBBB_______B___B
B__BBBBB__B_____B__B__BBB__B___B
BE_B______B_____B__B__B____BB__B
B__B______B__BBBB__B_______BB__B
B__B__BB_____B_____B_____BBBB__B
B_____B______B__E__B__E________B
B__E__B___BBBB_____B______E____B
BBBBBBB__B_________BBBBB__BBBBBB
BBBBBBB_________BBBBBBBB__BBBBBB
BBBBBBB_____BBBB__________B____B
BBBBB____E______E_________B__E_B
BBBBB________E____BBB__BBBB___BB
BBBBBBBBBBBBBB___BBBB________BBB
BBBBBBB______________________BBB
BBBBBBB____E_____E_____BBBBBBBBB
BBBBBBBBBBBBBBB_______BBBBBBBBBB
BBBBBBBBBBBBBBBBBBBBBBBBBBBBBBBB